_____________________
_____________________
_____________________
_____#####_#####_____
_____#___###___#_____
_____#_$_#o#_$_#_____
___#####E#+#E#####___
___#_G_L_____K_G_#___
___#_$_#B_?_P#_$_#___
___#####$_C_$#####___
___#_$_#B___P#_$_#___
___#___K__$__L___#___
___######D#D######___
_______#__#__#_______
_______#_$#$_#_______
_______#_W#W_#_______
_______#######_______
_____________________
_____________________
_____________________

